NON, NON, NON, NON, NON, NON, NON, NON, NON, NON, NON, NON, NON, NON, NON, NON, NON, NON, NON, NON, NON, NON, NON, NON, NON, NON, NON, NON, NON, NON, NON, NON, NON, NON, NON, NON, NON, NON, NON, NON, NON, NON, NON, NON, NON, NON, NON, NON, NON, NON, NON, NON, NON, NON, NON, NON, NON, NON, NON, NON, NON, NON, NON, NON, NON, NON, NON, NON, NON, NON, NON, NON, NON, NON, NON, NON, NON, NON, NON, NON, NON, NON, NON, NON, NON, NON, NON, NON, NON, NON, NON, NON, NON, NON, NON, NON, NON, NON, NON, NON, NON, NON, NON, NON, NON, NON, NON, NON, NON, NON, NON, NON, NON, NON, NON, NON, NON, NON, NON, NON, NON, NON, NON, NON, NON, NON, NON, NON, NON, NON, NON, NON, NON, NON, NON, NON, NON, NON, NON, NON, NON, NON, NON, NON, NON, NON, NON, NON, NON, NON, NON, NON, NON, NON, NON, NON, NON, NON, NON, NON, NON, NON, NON, NON, NON, NON, NON, NON, NON, NON, NON, NON, NON, NON, NON, NON, NON, NON, NON, NON, NON, NON, NON, NON, NON, NON, NON, NON, NON, NON, NON, NON, NON, NON, NON, NON, NON, NON, NON, NON, NON, NON, NON, NON, NON, NON, NON, NON, NON, NON, NON, NON, NON, NON, NON, NON, NON, NON, NON, NON, NON, NON, NON, NON, NON, NON, NON, NON, NON, NON, NON, NON, NON, NON, NON, NON, NON, NON, NON, NON, NON, NON, NON, NON, NON, NON, NON, NON, NON, NON, NON, NON, NON, NON, NON, NON, NON, NON, NON, NON, NON, NON, NON, NON, NON, NON, NON, NON, NON, NON, NON, NON, NON, NON, NON, NON, NON, NON, NON, NON, NON, NON, NON, NON, NON, NON, NON, NON, NON, NON, NON, NON, NON, NON, NON,
NON, NON, NON, NON, NON, NON, NON, NON, NON, NON, NON, NON, NON, NON, NON, NON, NON, NON, NON, NON, NON, NON, NON, NON, NON, NON, NON, NON, NON, NON, NON, NON, NON, NON, NON, NON, NON, NON, NON, NON, NON, NON, NON, NON, NON, NON, NON, NON, NON, NON, NON, NON, NON, NON, NON, NON, NON, NON, NON, NON, NON, NON, NON, NON, NON, NON, NON, NON, NON, NON, NON, NON, NON, NON, NON, NON, NON, NON, NON, NON, NON, NON, NON, NON, NON, NON, NON, NON, NON, NON, NON, NON, NON, NON, NON, NON, NON, NON, NON, NON, NON, TC1, NON, NON, NON, NON, NON, NON, NON, NON, NON, NON, NON, NON, NON, NON, NON, NON, NON, NON, NON, NON, NON, NON, NON, NON, NON, NON, NON, NON, NON, NON, NON, NON, NON, NON, TC1, NON, NON, NON, NON, NON, NON, NON, NON, NON, NON, NON, NON, NON, NON, NON, NON, NON, NON, NON, NON, NON, NON, NON, NON, NON, NON, NON, NON, NON, NON, NON, NON, NON, NON, NON, NON, NON, NON, NON, NON, NON, NON, NON, NON, NON, NON, NON, NON, NON, NON, NON, NON, NON, NON, NON, NON, NON, NON, NON, NON, NON, NON, NON, NON, NON, NON, NON, NON, NON, NON, NON, NON, NON, NON, NON, NON, NON, NON, NON, NON, NON, NON, NON, NON, NON, NON, NON, NON, NON, NON, NON, NON, NON, NON, NON, NON, NON, NON, NW1, NE1, NON, NON, NON, NON, NON, TC1, NON, NON, NON, NON, NON, NON, NON, NON, NON, NON, NON, NON, NON, NON, NON, NON, SOR, NON, NON, NON, NW1, NE1, NON, NON, NON, NW1, NE2, NW2, NE2, NW2, NE2, NW2, NE2, NW2, NE2, NW2, NE1, NON, NON, NON, NON, NON, NON, NON, NON, NON, NON, NON, NON, NON, NON, NW1,
NON, NON, NON, NON, NON, NON, NON, NON, NON, NON, NON, NON, NON, NON, NON, NON, NON, NON, NON, NON, NON, NON, NON, NON, NON, NON, NON, NON, NON, NON, NON, NON, NON, NON, NON, NON, NON, NON, NON, NON, NON, NON, NON, NON, NON, NON, NON, NON, NON, NON, NON, NON, NON, NON, NON, NON, NON, NON, NON, NON, NON, NON, NON, NON, NON, NON, NON, NON, NON, NON, NON, NON, NON, NON, NON, NON, NON, NON, NON, NON, NON, NON, NON, NON, NON, NON, NON, NON, NON, NON, NON, NON, NON, NON, NON, NON, NON, NON, NON, NW1, NE2, NW2, NE1, NON, NON, NON, NON, NON, NON, NON, NON, NON, NON, NON, NON, NON, NON, NON, NON, NON, NON, NON, NON, NON, NON, NON, NON, NON, NON, NON, NON, NON, NON, NON, NON, NW1, NE2, NE1, NON, NON, NON, NON, NON, NON, NON, NON, NON, NON, NON, NON, NON, NON, NON, NON, NON, NON, NON, NON, NON, NON, NON, NON, NON, NON, NON, NON, NON, NON, NON, NON, NON, NON, NON, NON, NON, NON, NON, NON, NON, NON, NON, NON, NON, NON, NON, NON, NON, NON, NON, NON, NON, NON, NON, NON, NON, NON, NON, NON, NON, NON, NON, NON, NON, NON, NON, NON, NON, NON, NON, NON, NON, NON, NON, NON, NON, NON, NON, NON, NON, NON, NON, NON, NON, NON, NON, NON, NON, NON, NON, NW1, NE2, NW2, NE1, NON, NON, SW1, SE1, NON, NON, NON, NON, NW1, NE2, NE1, NON, NON, NON, NON, NON, NON, NON, NON, NON, NON, NON, NON, NON, NW1, NE2, NW2, NE1, NON, NON, SW1, SE1, NON, NON, NON, SW3, NE4, NE4, SW4, NE4, SE4, NE4, NW4, NE4, SW4, SE4, SE3, NON, NON, NON, NON, NON, NON, NON, NON, NON, NON, NON, NON, NON, NON, SW3,
NON, NON, NON, NON, NON, NON, NON, NON, NON, NON, NON, NON, NON, NON, NON, NON, NON, NON, NON, NON, NON, NON, NON, NON, NON, NON, NON, NON, NON, NON, NON, NON, NON, NON, NON, NON, NON, NON, NON, NON, NON, NON, NON, NON, NON, NON, NON, NON, NON, NON, NON, NON, NON, NON, NON, NON, NON, NON, NON, NON, NON, NON, NON, NON, NON, NON, NON, NON, NON, NON, NON, NON, NON, NON, NON, NON, NON, NON, NON, NON, NON, NON, NON, NON, NON, NON, NON, NON, NON, NON, NON, NON, NON, NON, NON, NON, NON, NON, NON, SW1, SE2, SW2, SE1, NON, NON, NON, NON, NON, NON, NON, NON, NON, NON, NON, NON, NON, NON, NON, NON, NON, NON, NON, NON, NON, NON, NON, NON, NON, NON, NON, NON, NON, NON, NON, NON, SW1, SE2, SE1, NON, NON, NON, NON, NON, NON, NON, NON, NON, NON, NON, NON, NON, NON, NON, NON, NON, NON, NON, NON, NON, NON, NON, NON, NON, NON, NON, NON, NON, NON, NON, NON, NON, NON, NON, NON, NON, NON, NON, NON, NON, NON, NON, NON, NON, NON, NON, NON, NON, NON, NON, NON, NON, NON, NON, NON, NON, NON, NON, NON, NON, NON, NON, NON, NON, NON, NON, NON, NON, NON, NON, NON, NON, NON, NON, NON, NON, NON, NON, NON, NON, NON, NON, NON, NON, NON, NW1, NE2, NW2, NE1, NON, NW3, NE4, NW4, SE3, NON, NON, NON, NON, NON, NON, NON, NON, SW1, SE2, SE1, NON, NON, NON, NON, NON, NON, NON, NON, NON, SOR, NON, NON, NON, SW1, SE2, SW2, SE1, NON, NON, NON, NON, NON, NON, NON, NW3, SE4, SE4, NW4, SE4, SW4, SE4, SE4, NE4, SE4, SW4, NE3, NON, NON, NON, NON, NON, NON, NON, NON, NON, NON, NON, NON, NON, NON, NW3,
NON, NON, NON, NON, NON, NON, NON, NON, NON, NON, NON, NON, NON, NON, NON, NON, NON, NON, NON, NON, NON, NON, NON, NON, NON, NON, NON, NON, NON, NON, NON, NON, NON, NON, NON, NON, NON, NON, NON, NON, NON, NON, NON, NON, NON, NON, NON, NON, NON, NON, NON, NW1, NE1, NON, NON, NON, NON, NON, NON, NON, NON, NON, NON, NON, NON, NON, NON, NON, NON, NON, NON, NON, NON, NON, NON, NON, NON, NON, NON, NON, NON, NON, NON, NON, NON, NON, NW1, NE2, NW2, NE1, NON, NON, NON, NW1, NE2, NW2, NE1, NON, NON, NON, NON, NON, NON, NON, NON, NON, NON, NON, NON, NON, NON, NON, NON, NON, NON, NON, NON, NON, NON, NON, NON, NON, NON, NON, NON, NON, NW1, NE2, NW2, NE2, NW2, NE1, NON, NON, NON, NON, NON, NON, NON, NON, NON, NON, NON, NON, NON, NON, NON, NON, NON, NON, NON, NON, NON, NON, NON, NON, NON, NON, NON, NON, NON, NON, NON, NON, NON, NON, NON, NON, NON, NON, NON, NON, NON, NON, NON, NON, NON, NON, NON, NON, NON, NON, NON, NON, NON, NON, NON, NON, NON, NON, NON, NON, NON, NON, NON, NON, NON, NON, NON, NON, NON, NON, NON, NON, NON, NON, NON, NON, NON, NON, NON, SOR, NON, NON, NON, NON, NON, NON, NON, NON, NON, NON, NON, NON, SW1, SE2, SW2, SE1, NON, SW1, SE2, SW2, SE1, NON, NON, NON, NON, NON, NON, NON, NON, NON, NON, NON, NON, NON, NON, NON, NON, NON, NON, NW1, NE2, NW2, NE1, NON, NON, NON, NON, NON, NON, NON, NON, NON, NON, NON, NON, NON, SW3, SW4, SW4, SE4, NW4, SE4, SW4, NE4, SE4, NE4, SW4, SE3, NON, NON, NON, NON, NON, NON, NON, NON, NON, NON, NON, NON, NON, NON, SW3,
NON, NON, NON, NON, NON, NON, NON, NON, NON, NON, NON, NON, NON, NON, NON, NON, NON, NON, NON, NON, NON, NON, NON, NON, NON, NON, NON, NON, NON, NON, NON, NON, NON, NON, NON, NON, NON, NON, NON, NON, NON, NON, NON, NON, NON, NON, NON, NON, NON, NON, NON, SW1, SE1, NON, NON, NON, NON, NON, NON, NON, NON, NON, NON, NON, NON, NON, NON, NON, NON, NON, NON, NON, NON, NON, NON, SOR, NON, NON, NON, NON, NON, NON, NON, NON, NON, NON, SW1, SE2, SW2, SE1, NON, NON, NON, SW1, SE2, SW2, SE1, NON, NON, NON, NON, NON, NON, NON, NON, NON, NON, NON, NON, NW1, NE2, NW2, NE1, NON, NON, NON, NON, NON, NON, NON, NON, NON, NON, NON, NON, NON, SW1, SE2, SW2, SE2, SW2, SE1, NON, NON, NON, NON, NON, NON, NON, NON, NON, NON, NON, NON, NON, NON, NON, NON, NON, NON, NON, NON, NON, NON, NON, NON, NON, NON, NON, NON, NON, NON, NON, NON, NON, NON, NON, NON, NON, NON, NON, NON, NON, NON, NON, NON, NON, NON, NON, NON, NON, NON, NON, NON, NON, NON, NON, NON, NON, NON, NON, NON, NON, NON, NON, NON, NON, NON, NON, NON, NON, NON, NON, NON, NON, NON, SOR, NON, NON, NW1, NE2, NW2, NE1, NON, NON, NON, NON, NON, NON, NON, NON, NON, NON, NON, NON, NON, NON, NON, NON, NON, NON, NON, NON, NON, NON, NON, NON, NON, NON, NON, NON, NON, NON, NON, NON, NON, NON, NON, NON, NON, NON, SW1, SE2, SW2, SE1, NON, NON, NON, NON, NON, NON, NON, NON, NON, NON, NON, NON, NON, NW3, SE4, NE4, SE4, SE4, NE4, SE4, SW4, SW4, SE4, SE4, NE3, NON, NON, NON, NON, NON, NON, NON, NON, NON, NON, NON, NON, NON, NON, NW3,
NON, NON, NON, NON, NON, NON, NON, NON, NON, NON, NON, NON, NON, NON, NON, NON, NON, NON, NON, NON, NON, NON, NON, NON, NON, NON, NON, NON, NON, NON, NON, NON, NON, NON, NON, NON, NON, NON, NON, NON, NON, NON, NON, NON, NON, NON, NON, NON, NON, NON, NON, NON, NON, NON, NON, NON, NON, NON, NON, NON, NON, NON, NON, NON, NON, NON, NON, NON, SOR, NON, NON, NON, NW1, NE2, NW2, NE1, NON, NON, NON, NW1, NE2, NW2, NE1, NON, NON, NON, NON, NON, NON, NON, NON, NON, NON, NON, NON, NON, NON, NON, NON, NON, NON, NON, NON, NON, NON, NON, NON, NON, NON, SW3, NE4, NE4, SE3, NON, NON, NON, NON, NON, NON, NON, NON, NON, NON, NON, NON, NON, NON, NON, NON, NON, NON, NON, NON, NON, NON, NON, NON, NON, NON, NON, NON, NON, NON, NON, NON, NON, NON, NON, NON, NON, NON, NON, NON, NON, NON, NON, NON, NON, NON, NON, NW1, NE1, NON, NON, NON, NON, NON, NON, NON, NW1, NE1, NON, NON, NON, NON, NON, NON, NON, NON, NON, NON, NON, NON, NON, NON, NON, NON, NON, NON, NON, NON, NON, NON, NON, NON, NON, NON, NON, NON, NON, NON, NON, NON, NON, NW1, NE2, NW2, NE1, NON, NW3, NE4, NE4, NE3, NON, NON, NON, NON, NON, NON, NW1, NE2, NW2, NE1, NON, NON, NON, NON, NON, NON, NON, NON, NON, NON, NON, NON, NON, NON, NON, NON, NON, NON, NON, NON, NON, NON, NON, NON, NON, NON, NON, NON, NON, NON, NON, NON, NON, NON, NON, NON, NON, NON, NON, NON, NON, NON, NON, NON, NON, SW3, SE4, SE4, SW4, SW4, SW4, NW4, SE4, NE4, NW4, NW4, SE3, NON, NON, NON, NON, NON, NON, NW1, NE1, NON, NON, NON, NON, NON, NON, SW3,
NON, NON, NON, NON, NON, NON, NON, NON, NON, NON, NON, NON, NON, NON, NON, NON, NON, NON, NON, NON, NON, NON, NON, NON, NON, NON, SOR, NON, NON, NON, NON, NON, NON, NON, NON, NON, NON, NON, NON, NW1, NE1, TC1, NON, NON, NON, NON, NON, NON, NON, NON, SOR, NON, NON, NON, NON, NON, NON, NON, NON, NW1, NE2, NW2, NE1, NON, NON, NW1, NE2, NW2, NE1, NON, NON, NON, SW1, SE2, SW2, SE1, NON, NON, NON, SW3, NE4, NE4, SE3, NON, NON, NON, NON, NON, NON, NON, NON, NON, NON, NON, NON, NON, NON, NON, NON, NON, NON, NON, NON, NON, NON, NON, NON, NON, NON, SW3, NW4, NE4, SE3, NON, NON, NON, SOR, NON, NON, NON, NON, NON, NON, NON, NON, NON, NON, NON, NON, NON, NON, NON, NON, NON, NON, NON, NON, NON, NON, NON, NON, NON, NON, NON, NON, NON, NON, NON, NON, NON, NON, NON, NW1, NE1, NON, NON, NW1, NE1, NON, NON, SW1, SE1, NON, NON, NON, NON, NON, NON, NON, SW1, SE1, NON, NON, NON, NON, NON, NON, NON, NON, NW1, NE2, NW2, NE2, NW2, NE1, NON, NON, NON, NON, NON, NON, NON, NON, NON, NON, NON, NON, NON, SOR, NON, NON, NON, NW1, NE2, NW5, NE4, NE4, NE3, NON, SW1, SE2, SW2, SE1, NON, NON, NON, NON, NON, NON, SW1, SE2, SW2, SE1, NON, NON, NON, NON, NON, NON, NON, NON, NON, NON, NON, NON, NON, NON, NON, NON, NON, SOR, NON, NON, NON, NON, NON, NON, NON, NON, NON, NON, NON, NON, NON, NON, NON, NON, NON, NON, NON, NON, NON, NON, NON, NON, NON, NON, NON, NW3, NE4, SW4, SE4, SE4, NE4, SE4, SW4, SE4, SE4, NE4, SE3, NON, NON, NON, NON, NON, NON, SW1, SE1, NON, NON, NON, NON, NON, NON, SW3,
NON, NON, NON, NON, WIZ, NON, NON, NON, TC1, NON, NON, NON, NON, NON, NON, NON, NON, NW1, NE2, NW2, NE1, NON, NON, NW1, NE2, NW2, NE1, NON, NON, NON, NON, NON, NON, NON, NON, NON, NON, NW1, NE2, NW5, NE5, NW2, NE1, NON, NON, NON, NON, NW1, NE2, NW2, NE1, NON, NON, NON, NW1, NE1, NON, NON, NON, SW1, SE2, SW2, SE1, NON, NON, SW3, NE4, NE4, SE3, NON, NON, NON, NON, NON, NON, NON, NON, NON, NON, SW3, NE4, NE4, SE3, NON, NON, NON, NON, NON, NON, NON, NON, NON, NON, NON, NON, NON, NON, NON, NON, NON, NON, NON, NON, NON, NON, NON, NON, NW1, NE2, NW5, NE4, NE4, SE3, NON, NW1, NE2, NW2, NE1, NON, NON, NON, NON, NON, NW1, NE1, NON, NON, NON, NON, NON, NON, NON, NON, NON, NON, NON, NON, NON, NON, NON, NW1, NE1, NON, NON, NW1, NE1, NON, NON, NW1, NE1, NON, NON, SW1, SE1, NON, NON, SW3, SE3, NON, NON, NON, NON, NON, NON, NON, NW1, NE1, NON, NON, NON, NON, NON, NON, NON, NON, NON, NW1, NE1, NON, SW1, SE2, SW2, SE2, SW5, SE3, NON, NON, NON, NON, NON, NON, NON, NON, NON, NON, NON, NW1, NE2, NE1, NON, NON, NON, SW3, NE4, SE4, NE4, NE4, SE3, NON, NON, NON, NON, NON, NON, NW1, NE2, NW2, NE1, NON, NON, NON, NON, NON, NON, NON, NON, NON, NON, NON, NON, NON, NON, NON, NON, NON, NON, NON, NON, NW1, NE2, NW2, NE1, NON, NON, NON, NON, NON, NW1, NE2, NW2, NE1, NON, NON, NON, NON, NON, NON, NON, NON, NON, NON, NON, NON, NON, NON, NON, NON, NON, SW3, SE4, SE4, NE4, SW4, SE4, SW4, SE4, NW4, SW4, NE4, NE3, NON, NON, NON, NON, NON, NON, NON, NON, NON, NON, NON, NON, NON, NON, NW3,
NON, NON, NON, NW1, NW2, NE2, NW2, NE2, NW2, NE1, NON, NON, NON, NON, NON, NON, NON, SW1, SE2, SW2, SE1, NON, NON, SW1, SE2, SW2, SE1, NON, NON, NON, NON, NON, NON, NW1, NE1, NON, NON, SW3, NE4, NE4, NE4, NE4, SE3, NON, NON, NON, NON, SW1, SE2, SW2, SE1, NON, NON, NON, SW3, NE3, NON, NON, NON, NON, NON, NON, NON, NON, NON, SW3, NE4, NE4, SE3, NON, NON, NON, NON, NON, NON, NON, NON, NON, NON, SW3, NE4, SE4, SE3, NON, NON, NON, NON, NON, NON, NON, NON, NON, NON, NON, NON, NON, NON, NON, NON, NON, NON, NON, NON, NON, NON, NON, NON, SW3, SE4, NE4, NW4, SE4, SE3, NON, SW1, SE2, SW2, SE1, NON, NON, NON, NON, NON, SW3, NE3, NON, NON, NON, NON, NON, NON, NON, NON, NON, NON, NON, NON, NON, NON, NON, SW3, SE3, NON, NON, NW3, NE3, NON, NON, SW1, SE1, NON, NON, NON, NON, NON, NON, SW3, SE3, NON, NON, NON, NON, NON, NON, NON, SW3, SE3, NON, NON, NON, NON, NON, NON, NON, NON, NON, SW3, SE3, NON, NON, NON, NON, NON, NW3, SE3, NON, NON, NON, NON, NON, NON, NON, NON, NON, NON, NON, SW3, NE4, NE3, NON, NON, NON, SW3, NE4, SW4, SE4, NE4, NE3, NON, NON, NON, NON, NON, NON, SW3, NE4, NE4, NE3, NON, NON, NON, NON, NON, NON, NON, NON, NON, NON, NON, NON, NON, NON, NON, NON, NON, NON, NON, NON, NW3, SE4, NW4, NE3, NON, NON, NON, NON, NON, SW3, NE4, SE4, SE3, NON, NON, NON, NON, NON, NON, NON, NON, NON, NON, NON, NON, NON, NON, NON, NON, NON, NW3, SE4, SW4, SE4, NE4, NW4, SW4, SE4, SE4, SE4, NE4, SE3, NON, NON, NON, NON, NON, NON, NON, NON, NON, NON, NON, NON, NON, NON, SW3,
MCH, NON, NON, SW3, NE4, NE4, NE4, SW4, NE4, SE3, NON, NON, NON, ROB, NON, NON, NON, NON, NON, NON, NON, NON, NON, NON, NON, NON, NON, NON, NON, NON, NON, NON, NON, SW3, NE3, NON, NON, SW3, NE4, NE4, NE4, NE4, NE3, NON, NON, NON, NON, NON, NON, NON, NON, NON, NON, NON, SW3, SE3, NON, NON, NON, NON, NON, NON, NON, NON, NON, SW3, NE4, NE4, SE3, NON, NON, NON, NON, NON, NON, NON, NON, NON, NON, SW3, NE4, NE4, SE3, NON, NON, NON, SOR, NON, NON, NON, NON, NON, NON, NON, SOR, NON, NON, NON, NON, NON, NON, NON, NON, NON, SOR, NON, NON, SW3, NE4, NE4, NE4, NE4, SE3, NON, NON, NON, NON, NON, NON, NON, NON, NON, NON, SW3, NE3, NON, NON, NON, NON, NON, SOR, NON, NON, NON, NON, NON, NON, NON, SOR, NON, SW3, SE3, NON, NON, SW3, SE3, SOR, NON, NON, NON, NON, NON, NON, NON, NON, SOR, SW3, SE3, NON, NON, NON, NON, NON, SOR, NON, SW3, SE3, NON, NON, NON, NON, NON, NON, SOR, NON, NON, SW3, SE3, NON, NON, NON, TC1, TC1, NW3, SE3, NON, NON, NON, SOR, NON, NON, NW1, NE2, NE1, NON, NON, SW3, NE4, SE3, NON, NON, NON, SW3, NW4, SE4, NW4, SE4, SE3, NON, NON, SOR, NON, NON, NON, SW3, NE4, NE4, NE3, NON, NON, NON, SOR, NON, NON, NON, NON, NON, SOR, NON, NON, NON, NON, SOR, NON, NON, NON, NON, NON, SW3, NE4, SE4, SE3, NON, NON, NON, SOR, NON, SW3, NW4, SE4, NE3, NON, NON, NON, SOR, NON, NON, NON, NON, NON, NON, SOR, NON, NON, NON, NON, SOR, NON, SW3, SW4, SE4, NE4, NW4, SE4, SW4, SE4, NW4, SE4, SE4, NE3, NON, NON, NON, NON, NON, NON, NON, NON, NON, NON, NON, NON, NON, NON, SW3,
NW1, NE2, NW2, NW5, NE4, SE4, NE4, NW4, SE4, NE5, NW2, NE2, NW2, NE2, NW2, NE2, NW2, NE2, NW2, NE2, NW2, NE2, NW2, NE2, NW2, NE2, NW2, NE2, NW2, NE2, NW2, NE2, NW2, NW5, NE5, NE2, NW2, NW5, SE4, SE4, SE4, SE4, NE5, NE2, NW2, NE2, NW2, NE2, NW2, NE2, NW2, NE2, NW2, NE2, NW5, NE5, NW2, NE2, NW2, NE2, NW2, NE2, NW2, NE2, NW2, NW5, SE4, SE4, NE5, NW2, NE2, NW2, NE2, NW2, NE2, NW2, NE2, NW2, NE2, NW5, SE4, SE4, NE5, NW2, NE2, NW2, NE2, NW2, NE2, NW2, NE2, NW2, NE2, NW2, NE2, NW2, NE2, NW2, NE2, NW2, NE2, NW2, NE2, NW2, NE2, NW2, NE2, NW5, NE4, NW4, SE4, NE4, NE5, NW2, NE2, NW2, NE2, NW2, NE2, NW2, NE2, NW2, NE2, NW5, NE5, NW2, NE2, NW2, NE2, NW2, NE2, NW2, NE2, NW2, NE2, NW2, NE2, NW2, NE2, NW2, NW5, NE5, NE2, NW2, NW5, NE5, NE2, NW2, NW2, NE2, NE2, NW2, NW2, NE2, NE2, NW2, NW5, NE5, NE2, NW2, NE2, NW2, NE2, NW2, NE2, NW5, NE5, NW2, NE2, NW2, NE2, NW2, NE2, NW2, NE2, NW2, NW5, NE5, NE2, NW2, NE2, NW2, NE2, NW5, NE5, NW2, NE2, NW2, NE2, NW2, NE2, NW5, NE4, NE5, NE2, NW2, NW5, NE4, NE5, NW2, NE2, NW2, NW5, SW4, SE4, NW4, SE4, NE5, NE2, NW2, NE2, NW2, NE2, NW2, NW5, NE4, NE4, NE5, NE2, NW2, NE2, NW2, NE2, NW2, NE2, NW2, NE2, NW2, NE2, NW2, NE2, NW2, NE2, NW2, NE2, NW2, NE2, NW2, NW5, SE4, SW4, NE5, NE2, NW2, NE2, NW2, NE2, NW5, NE4, NW4, NE5, NW2, NE2, NW2, NE2, NW2, NE2, NW2, NE2, NW2, NE2, NW2, NE2, NW2, NE2, NW2, NE2, NW2, NW5, NW4, NW4, NW4, SW4, NW4, SE4, NE4, SE4, SE4, NE4, NE5, NE2, NW2, NE2, NW2, NE2, NW2, NE2, NW2, NE2, NW2, NE2, NW2, NE2, NW2, NW5
