NON, NON, NON, NON, NON, NON, NON, NON, NON, NON, NON, NON, NON, NON, NON, NON, NON, NON, NON, NON, NON, NON, NON, NON, NON, NON, NON, NON, NON, NON, NON, NON, NON, NON, NON, NON, NON, NON, NON, NON, NON, NON, NON, NON, NON, NON, NON, NON, NON, NON, NON, BIR, NON, NON, NON, NON, NON, NON, NON, NON, NON, BIR, NON, NON, NON, NON, NON, NON, NON, NON, NON, NON, NON, NON, NON, NON, NON, NON, NON, NON, NON, NON, NON, NON, NON, NON, NON, NON, NON, NON, NON, NON, NON, NON, NON, NON, NON, NON, NON, NON, NON, NON, NON, NON, NON, NON, NON, NON, NON, NON, NON, NON, NON, NON, NON, NON, NON, NON, NON, NON, NON, NON, NON, NON, NON, NON, NON, NON, NON, NON, NON, NON, NON, NON, NON, NON, NON, NON, NON, NON, NON, NON, NON, NON, NON, NON, NON, NON, NON, NON, NON, NON, NON, NON, NON, NON, NON, NON, NON, NON, NON, NON, NON, NON, NON, NON, NON, NON, NON, NON, NON, NON, NON, NON, NON, NON, NON, NON, NON, NON, NON, NON, NON, NON, NON, NON, NON, NON, NON, NON, NON, NON, NON, NON, NON, NON, NON, NON, NON, NON, NON, NON, NON, NON, NON, NON, NON, NON, NON, NON, NON, NON, NON, NON, NON, NON, NON, NON, NON, NON, NON, NON, NON, NON, NON, NON, NON, NON, NON, NON, NON, NON, NON, NON, NON, NON, NON, NON, NON, NON, NON, NON, NON, NON, NON, NON, NON, NON, NON, NON, NON, NON, NON, NON, NON, NON, NON, NON, NON, NON,
NON, NON, NON, NON, NON, NON, NON, NON, NON, NON, NON, NON, NON, NON, NON, NON, NON, NON, NON, AW1, AN1, NON, NON, NON, NON, NON, NON, NON, NON, NON, NON, NON, NON, NON, NON, NON, NON, NON, NON, NON, NON, NON, NON, NON, AW1, AN2, AN1, WW1, WE2, WW2, WE2, WW2, WE2, WE2, WE2, WW2, WW2, WE2, WW2, WE2, WW2, WE2, WE2, WW2, WE1, AW1, AN1, NON, NON, NON, NON, NON, NON, NON, NON, NON, NON, NON, NON, NON, NON, NON, NON, NON, NON, NON, NON, NON, NON, NON, NON, NON, NON, NON, NON, NON, NON, NON, NON, NON, NON, NON, NON, NON, NON, NON, NON, NON, NON, NON, NON, NON, NON, NON, NON, NON, NON, NON, NON, NON, NON, NON, AW1, AN1, NON, NON, NON, AW1, AN1, NON, NON, NON, NON, NON, NON, NON, NON, NON, NON, NON, NON, NON, NON, NON, NON, NON, NON, NON, NON, NON, NON, NON, NON, NON, NON, NON, NON, NON, NON, NON, NON, NON, NON, NON, NON, NON, NON, NON, NON, NON, NON, NON, NON, NON, NON, NON, NON, NON, NON, NON, NON, NON, NON, NON, NON, NON, NON, NON, NON, NON, NON, NON, NON, NON, NON, NON, NON, NON, NON, NON, NON, NON, NON, NON, NON, NON, NON, NON, NON, NON, NON, NON, NON, NON, NON, NON, NON, NON, NON, NON, NON, NON, NON, NON, NON, NON, NON, NON, NON, NON, NON, NON, NON, NON, NON, NON, NON, NON, NON, NON, NON, NON, NON, NON, NON, NON, NON, NON, NON, NON, NON, NON, NON, NON, NON, NON, NON, NON, NON, NON,
NON, MCH, NON, NON, NON, NON, NON, AW1, AN1, NON, NON, NON, NON, NON, NON, NON, NON, NON, NON, AS1, AE1, NON, NON, NON, NON, NON, NON, NON, NON, NON, NON, NON, NON, NON, AW1, AN1, NON, NON, NON, AW1, AN1, NON, NON, NON, AS1, AE2, AE1, NON, NON, NON, NON, NON, NON, NON, NON, NON, NON, NON, NON, NON, NON, NON, NON, NON, NON, AS1, AE1, NON, NON, NON, NON, NON, NON, NON, NON, NON, NON, NON, NON, NON, NON, NON, NON, NON, NON, NON, NON, NON, NON, NON, NON, NON, NON, NON, NON, NON, NON, NON, NON, NON, NON, NON, NON, NON, NON, NON, NON, NON, NON, NON, NON, NON, NON, BIR, NON, NON, NON, NON, NON, NON, NON, NON, AS1, AE1, NON, NON, NON, AS3, AN3, NON, NON, NON, NON, NON, NON, NON, NON, NON, NON, NON, NON, NON, NON, NON, NON, NON, NON, NON, NON, NON, NON, NON, NON, NON, NON, NON, NON, NON, NON, NON, NON, NON, NON, NON, NON, NON, NON, NON, NON, NON, NON, NON, NON, NON, NON, NON, NON, NON, NON, NON, NON, NON, NON, NON, NON, NON, NON, NON, NON, NON, NON, NON, NON, NON, NON, NON, NON, NON, NON, NON, NON, NON, NON, NON, NON, NON, NON, NON, NON, NON, NON, NON, NON, NON, NON, NON, NON, NON, NON, NON, NON, NON, NON, NON, NON, NON, NON, NON, NON, NON, NON, NON, NON, NON, NON, NON, NON, NON, NON, NON, NON, NON, NON, NON, NON, NON, NON, NON, NON, NON, NON, NON, NON, NON, NON, NON, NON, NON, NON, NON,
AW1, AN2, AN1, NON, NON, NON, NON, AS1, AE1, NON, NON, NON, AW1, AN2, AW2, AN1, NON, NON, NON, NON, NON, NON, NON, NON, NON, NON, AN1, AN2, AW2, AN1, NON, NON, NON, NON, AS1, AE1, NON, NON, NON, AS1, AE1, NON, NON, NON, NON, NON, NON, NON, NON, NON, NON, NON, NON, NON, NON, NON, NON, NON, NON, NON, NON, NON, NON, NON, NON, NON, NON, NON, NON, NON, NON, NON, NON, NON, NON, NON, TCM, NON, NON, NON, NON, NON, NON, NON, NON, NON, NON, NON, NON, NON, NON, NON, NON, NON, NON, NON, NON, NON, NON, NON, NON, NON, NON, NON, NON, NON, NON, NON, NON, NON, NON, NON, AW1, AN2, AN1, NON, NON, AW1, AN1, NON, NON, NON, NON, NON, NON, NON, NON, AS3, AN3, NON, NON, NON, NON, NON, NON, NON, NON, NON, NON, NON, NON, NON, NON, NON, NON, NON, NON, NON, NON, NON, NON, NON, NON, NON, NON, NON, NON, NON, NON, NON, NON, NON, NON, NON, NON, NON, NON, NON, NON, NON, NON, NON, NON, NON, NON, NON, NON, NON, NON, NON, NON, NON, NON, NON, NON, NON, NON, NON, NON, NON, NON, NON, NON, NON, NON, NON, NON, NON, NON, NON, NON, NON, NON, NON, NON, NON, NON, NON, NON, NON, NON, NON, NON, NON, NON, NON, NON, NON, NON, NON, NON, NON, NON, NON, NON, NON, NON, NON, NON, NON, NON, NON, NON, NON, NON, NON, NON, NON, NON, NON, NON, NON, NON, NON, NON, NON, NON, NON, NON, NON, NON, NON, NON, NON, NON, NON, NON, NON, NON, NON,
AS1, AE2, AE1, NON, NON, NON, NON, NON, NON, NON, NON, NON, AS1, AE2, AS2, AE1, NON, NON, NON, NON, NON, NON, NON, NON, NON, NON, AS1, AE2, AS2, AE1, NON, NON, NON, NON, NON, NON, NON, NON, NON, NON, NON, NON, NON, NON, NON, NON, NON, NON, NON, NON, NON, NON, NON, NON, NON, NON, NON, NON, NON, NON, NON, NON, NON, NON, NON, NON, NON, NON, NON, NON, NON, NON, NON, NON, NON, AW1, AN2, AN1, NON, NON, NON, NON, NON, NON, NON, NON, NON, NON, NON, NON, NON, NON, NON, NON, NON, NON, NON, NON, NON, NON, NON, NON, NON, NON, NON, NON, NON, NON, BIR, NON, NON, NON, AS1, AE2, AE1, NON, NON, AS1, AE1, NON, NON, NON, NON, NON, NON, NON, NON, AS3, AN3, NON, NON, NON, NON, NON, NON, NON, NON, NON, NON, NON, NON, NON, NON, NON, NON, NON, NON, NON, NON, NON, NON, NON, NON, NON, NON, NON, NON, NON, NON, NON, NON, NON, NON, NON, NON, NON, NON, NON, NON, NON, NON, NON, NON, NON, NON, NON, NON, NON, NON, NON, NON, NON, NON, NON, NON, NON, NON, NON, NON, NON, NON, NON, NON, NON, NON, NON, NON, NON, NON, NON, NON, NON, NON, NON, NON, NON, NON, NON, NON, NON, NON, NON, NON, NON, NON, NON, NON, NON, NON, NON, NON, NON, NON, NON, NON, NON, NON, NON, NON, NON, NON, NON, NON, NON, NON, NON, NON, NON, NON, NON, NON, NON, NON, NON, NON, NON, NON, NON, NON, NON, NON, NON, NON, NON, NON, NON, NON, NON, NON, NON,
NON, NON, NON, NON, NON, NON, NON, NON, NON, NON, NON, NON, NON, NON, NON, NON, NON, NON, NON, NON, NON, NON, NON, BIR, NON, NON, NON, NON, NON, NON, NON, NON, NON, NON, NON, NON, NON, NON, NON, NON, NON, NON, NON, NON, NON, NON, NON, NON, NON, NON, NON, NON, NON, NON, NON, NON, NON, NON, NON, NON, NON, NON, NON, NON, NON, NON, NON, NON, NON, NON, NON, NON, NON, NON, NON, AS1, AE2, AE1, NON, NON, NON, NON, NON, NON, NON, NON, NON, NON, NON, NON, NON, NON, NON, NON, NON, NON, NON, NON, NON, NON, NON, NON, NON, NON, NON, NON, NON, AW1, AN2, AN1, NON, NON, NON, NON, NON, NON, NON, NON, NON, NON, NON, NON, NON, NON, NON, NON, NON, AS3, AN3, NON, NON, NON, NON, NON, NON, NON, NON, NON, NON, NON, NON, NON, NON, NON, NON, NON, NON, NON, NON, NON, NON, NON, NON, NON, NON, NON, NON, NON, NON, NON, NON, NON, NON, NON, NON, NON, NON, NON, NON, NON, NON, NON, NON, NON, NON, NON, NON, NON, NON, NON, NON, NON, NON, NON, NON, NON, NON, NON, NON, NON, NON, NON, NON, NON, NON, NON, NON, NON, NON, NON, NON, NON, NON, NON, NON, NON, NON, NON, NON, NON, NON, NON, NON, NON, NON, NON, NON, NON, NON, NON, NON, NON, NON, NON, NON, NON, NON, NON, NON, NON, NON, NON, NON, NON, NON, NON, NON, NON, NON, NON, NON, NON, NON, NON, NON, NON, NON, NON, NON, NON, NON, NON, NON, NON, NON, NON, NON, NON, NON, NON,
NON, NON, NON, NON, NON, NON, NON, NON, NON, NON, NON, NON, NON, NON, NON, NON, NON, NON, NON, NON, NON, NON, AW1, AN2, AN1, NON, NON, NON, NON, NON, NON, NON, NON, NON, NON, NON, NON, NON, NON, NON, NON, NON, NON, NON, NON, NON, NON, NON, BIR, NON, NON, NON, NON, NON, NON, NON, NON, NON, NON, NON, NON, NON, NON, TCH, NON, NON, NON, TCN, NON, NON, NON, NON, NON, NON, NON, NON, NON, NON, NON, NON, NON, NON, NON, NON, NON, BIR, NON, NON, NON, NON, BIR, NON, NON, NON, NON, NON, NON, NON, NON, NON, NON, NON, NON, BIR, NON, NON, NON, AS1, AE2, AE1, NON, NON, NON, NON, NON, NON, NON, NON, NON, NON, NON, NON, NON, NON, NON, NON, NON, AS3, AN3, NON, NON, NON, NON, NON, NON, NON, NON, NON, NON, NON, NON, NON, NON, NON, NON, NON, NON, NON, NON, NON, NON, NON, NON, NON, NON, NON, NON, NON, NON, NON, NON, NON, NON, NON, NON, NON, NON, NON, NON, NON, NON, NON, NON, NON, NON, NON, NON, NON, NON, NON, NON, NON, NON, NON, NON, NON, NON, NON, NON, NON, NON, NON, NON, NON, NON, NON, NON, NON, NON, NON, NON, NON, NON, NON, NON, NON, NON, NON, NON, NON, NON, NON, NON, NON, NON, NON, NON, NON, NON, NON, NON, NON, NON, NON, NON, NON, NON, NON, NON, NON, NON, NON, NON, NON, NON, NON, NON, NON, NON, NON, NON, NON, NON, NON, NON, NON, NON, NON, NON, NON, NON, NON, NON, NON, NON, NON, NON, NON, NON, NON,
NON, NON, NON, NON, NON, NON, NON, NON, NON, NON, NON, NON, NON, NON, NON, NON, NON, NON, NON, NON, NON, NON, AS1, AE2, AE1, NON, NON, NON, NON, NON, NON, NON, NON, NON, NON, NON, NON, NON, NON, NON, NON, NON, NON, NON, NON, NON, NON, AW1, AN2, AW2, AN1, NON, NON, NON, AW1, AN1, NON, NON, NON, AW1, AN2, AW2, AN2, AW2, AN2, AW2, AN2, AW2, AN2, AW2, AN2, AN1, NON, NON, NON, NON, NON, NON, NON, NON, NON, NON, NON, NON, AW1, AN2, AN1, NON, NON, AW1, AN2, AN1, NON, NON, NON, BIR, TCH, NON, NON, NON, NON, NON, AW1, AN2, AN1, NON, NON, NON, NON, NON, NON, NON, NON, NON, NON, NON, NON, NON, NON, NON, NON, NON, NON, NON, NON, NON, NON, AS3, AN3, NON, NON, NON, NON, NON, NON, NON, NON, NON, NON, NON, NON, NON, NON, NON, NON, NON, NON, NON, NON, NON, NON, NON, NON, NON, NON, NON, NON, NON, NON, NON, NON, NON, NON, NON, NON, NON, NON, NON, NON, NON, NON, NON, NON, NON, NON, NON, NON, NON, NON, NON, NON, NON, NON, NON, NON, NON, NON, NON, NON, NON, NON, NON, NON, NON, NON, NON, NON, NON, NON, NON, NON, NON, NON, NON, NON, NON, NON, NON, NON, NON, NON, NON, NON, NON, NON, NON, NON, NON, NON, NON, NON, NON, NON, NON, NON, NON, NON, NON, NON, NON, NON, NON, NON, NON, NON, NON, NON, NON, NON, NON, NON, NON, NON, NON, NON, NON, NON, NON, NON, NON, NON, NON, NON, NON, NON, NON, NON, NON, NON, NON,
NON, NON, NON, NON, NON, NON, NON, NON, NON, NON, NON, NON, NON, NON, NON, NON, NON, NON, NON, NON, NON, NON, NON, NON, NON, NON, NON, NON, NON, NON, NON, NON, NON, NON, NON, NON, NON, NON, NON, NON, NON, NON, NON, NON, NON, NON, NON, AS1, AE2, AS2, AE1, NON, NON, NON, AS1, AE1, NON, NON, NON, AS3, AN4, AN4, AN4, AN4, AN4, AN4, AN4, AN4, AN4, AN4, AN4, AE3, NON, NON, NON, NON, NON, NON, NON, NON, NON, NON, NON, NON, AS1, AE2, AE1, NON, NON, AS1, AE2, AE1, NON, NON, AW1, AN2, AW2, AN1, NON, NON, NON, NON, AS1, AE2, AE1, NON, NON, NON, NON, NON, NON, NON, NON, NON, NON, NON, NON, NON, NON, NON, NON, NON, NON, NON, NON, NON, NON, AS3, AN3, NON, NON, NON, NON, NON, NON, NON, NON, NON, NON, NON, NON, NON, NON, NON, NON, NON, NON, NON, NON, NON, NON, NON, NON, NON, NON, NON, NON, NON, NON, NON, NON, NON, NON, NON, NON, NON, NON, NON, NON, NON, NON, NON, NON, NON, NON, NON, NON, NON, NON, NON, NON, NON, NON, NON, NON, NON, NON, NON, NON, NON, NON, NON, NON, NON, NON, NON, NON, NON, NON, NON, NON, NON, NON, NON, NON, NON, NON, NON, NON, NON, NON, NON, NON, NON, NON, NON, NON, NON, NON, NON, NON, NON, NON, NON, NON, NON, NON, NON, NON, NON, NON, NON, NON, NON, NON, NON, NON, NON, NON, NON, NON, NON, NON, NON, NON, NON, NON, NON, NON, NON, NON, NON, NON, NON, NON, NON, NON, NON, NON, NON,
NON, NON, NON, NON, NON, NON, NON, NON, NON, NON, NON, NON, NON, NON, NON, NON, NON, NON, NON, NON, NON, NON, NON, NON, NON, NON, NON, NON, NON, NON, NON, NON, NON, NON, NON, NON, NON, NON, NON, NON, NON, NON, NON, NON, NON, NON, NON, NON, NON, NON, NON, NON, NON, NON, NON, NON, NON, NON, NON, AS3, AN4, AN4, AN4, AN4, AN4, AN4, AN4, AN4, AN4, AN4, AN4, AE3, NON, NON, NON, NON, NON, NON, NON, NON, NON, NON, NON, NON, NON, NON, NON, NON, NON, NON, NON, NON, NON, NON, AS1, AE2, AS2, AE1, NON, NON, NON, NON, NON, NON, NON, NON, NON, NON, NON, NON, NON, NON, NON, NON, NON, NON, NON, NON, NON, NON, NON, NON, NON, NON, NON, NON, NON, AS3, AN3, NON, NON, NON, NON, NON, NON, NON, NON, NON, NON, NON, NON, NON, NON, NON, NON, NON, NON, NON, NON, NON, NON, NON, NON, NON, NON, NON, NON, NON, NON, NON, NON, NON, NON, NON, NON, NON, NON, NON, NON, NON, NON, NON, NON, NON, NON, NON, NON, NON, NON, NON, NON, NON, NON, NON, NON, NON, NON, NON, NON, NON, NON, NON, NON, NON, NON, NON, NON, NON, NON, NON, NON, NON, NON, NON, NON, NON, NON, NON, NON, NON, NON, NON, NON, NON, NON, NON, NON, NON, NON, NON, NON, NON, NON, NON, NON, NON, NON, NON, NON, NON, NON, NON, NON, NON, NON, NON, NON, NON, NON, NON, NON, NON, NON, NON, NON, NON, NON, NON, NON, NON, NON, NON, NON, NON, NON, NON, NON, NON, NON, NON,
NON, NON, NON, NON, NON, NON, BIR, NON, NON, NON, NON, NON, NON, NON, NON, BIR, NON, NON, NON, NON, NON, NON, NON, BIR, NON, NON, NON, NON, NON, NON, NON, NON, NON, NON, BIR, NON, NON, NON, NON, NON, NON, NON, NON, NON, BIR, NON, NON, NON, NON, NON, NON, NON, BIR, NON, NON, NON, NON, NON, NON, AS3, AN4, AN4, AN4, AN4, AN4, AN4, AN4, AN4, AN4, AN4, AN4, AE3, NON, NON, NON, NON, NON, NON, NON, NON, NON, NON, NON, NON, NON, NON, NON, NON, NON, NON, NON, NON, NON, NON, NON, NON, NON, NON, NON, NON, NON, NON, NON, NON, NON, NON, NON, NON, NON, NON, NON, NON, NON, NON, NON, NON, NON, NON, NON, BIR, NON, NON, NON, NON, BIR, TCH, NON, AS3, AN3, NON, NON, NON, NON, NON, NON, NON, NON, NON, NON, NON, NON, NON, NON, NON, NON, NON, NON, NON, NON, NON, NON, NON, NON, NON, NON, NON, NON, NON, NON, NON, NON, NON, NON, NON, NON, NON, NON, NON, NON, NON, NON, NON, NON, NON, NON, NON, NON, NON, NON, NON, NON, NON, NON, NON, NON, NON, NON, NON, NON, NON, NON, NON, NON, NON, NON, NON, NON, NON, NON, NON, NON, NON, NON, NON, NON, NON, NON, NON, NON, NON, NON, NON, NON, NON, NON, NON, NON, NON, NON, NON, NON, NON, NON, NON, NON, NON, NON, NON, NON, NON, NON, NON, NON, NON, NON, NON, NON, NON, NON, NON, NON, NON, NON, NON, NON, NON, NON, NON, NON, NON, NON, NON, NON, NON, NON, NON, NON, NON, NON, NON,
AW2, AN2, AW2, AN2, AW2, AN2, AW2, AN2, AW2, AN2, AW2, AN2, AW2, AN2, AW2, AN2, AW2, AW2, AN2, AW2, AW2, AN2, AW2, AN2, AW2, AN2, AW2, AN2, AW2, AN2, AW2, AN2, AW2, AN2, AW2, AN2, AW2, AW2, AN2, AW2, AW2, AN2, AW2, AN2, AW2, AN2, AW2, AN2, AW2, AN2, AW2, AN2, AW2, AN2, AW2, AN2, AW2, AW2, AN2, AW5, AN4, AN4, AN4, AN4, AN4, AN4, AN4, AN4, AN4, AN4, AN4, AN5, AW2, AN2, AW2, AN2, AW2, AW2, AN2, AW2, AW2, AN2, AW2, AN2, AW2, AN2, AW2, AN2, AW2, AN2, AW2, AN2, AW2, AN2, AW2, AN2, AW2, AW2, AN2, AW2, AW2, AN2, AW2, AN2, AW2, AN2, AW2, AN2, AW2, AN2, AW2, AN2, AW2, AN2, AW2, AN2, AW2, AW2, AN2, AW2, AW2, AN2, AW2, AN2, AW2, AN2, AW2, AW5, AN5, AN2, AW2, AN2, AW2, AN2, AW2, AN2, AW2, AW2, AN2, AW2, AW2, AN2, AW2, AN2, AW2, AN2, AW2, AN2, AW2, AN2, AW2, AN2, AW2, AN2, AW2, AN2, AW2, AW2, AN2, AW2, AW2, AN2, AW2, AN2, AW2, AN2, AW2, AN2, AW2, AN2, AW2, AN2, AW2, AN2, AW2, AN2, AW2, AW2, AN2, AW2, AW2, AN2, AW2, AN2, AW2, AN2, AW2, AN2, AW2, AN2, AW2, AN2, AW2, AN2, AW2, AN2, AW2, AW2, AN2, AW2, AW2, AN2, AW2, AN2, AW2, AN2, AW2, AN2, AW2, AN2, AW2, AN2, AW2, AN2, AW2, AN2, AW2, AW2, AN2, AW2, AW2, AN2, AW2, AN2, AW2, AN2, AW2, AN2, AW2, AN2, AW2, AN2, AW2, AN2, AW2, AN2, AW2, AW2, AN2, AW2, AW2, AN2, AW2, AN2, AW2, AN2, AW2, AN2, AW2, AN2, AW2, AN2, AW2, AN2, AW2, AN2, AW2, AW2, AN2, AW2
